111111111111
100P10000001
101011001101
1000C00C00E1
111111111111