11111111111X1111111111111111111111
110C0000x100000C00000C0000000E0001
1010010100100x00101001000z00010101
10000100101010100C1001000000010101
1P1000000C0000000000y000C0000000C1
1111111111111111111111111111111111