1111111111111111111111111111111111
100C00000000000C00000C000000000001
1E10010100100000101001000000010101
10100100101010100C1001000000010101
1P1000000C00000000000000C0000000C1
1111111111111111111111111111111111